0, 6
XXXXXXXXXXXXXXX
XERRRRRRRDEEEEX
XEUEEEEEEDEEEEX
XEUEERRDERRRRRD
XEUEEUEDEEEEEED
XEUERUEDEEEEEED
RRUEUEERRGEEEED
XEEEUEEEEEEEEED
XEEEULLLLLLLLLL
XXXXXXXXXXXXXXX