0, 6
XXXXXXXXXXXXXXX
XERRRRRRRDEEEEX
XEUXXEEEEDEEEEX
XEUXXRRDERRRRRD
XEUXXUEDEEEEEED
XEUERUEDEEXXXXD
RRUEUEERRGXXXXD
XEEEUEEEEEEEEED
XXXEULLLLLLLLLL
XXXXXXXXXXXXXXX