12, 0;0, 7
XXXXXXXXXXXXDXX
GLLLLLLLEEEEDEX
XEEEEEEUEEDLLEX
XERRRDEUEEDEEEX
XEUEEDEUEERRRDX
XEUEEDEUEEEEEDX
XEUEERRULLEEEDX
RRUEEEEEEUEEEDX
XEEEEEEEEULLLLX
XXXXXXXXXXXXXXX