0, 2;0, 5
XXXXXXXXXXXXXXX
XEEEEERRRDEEEEX
RRRRDEUEEDEEEEX
XEEEDEUEEDEERRG
XEEEDEUEERRRUEX
RRDEDEUERRRRRDX
XEDERRREUEEEEDX
XERRDEEEUEEEERG
XEEEDEERUEEEEEX
XXXXRRRUXXXXXXX
