12, 0;0, 7
XXXXXXXXXXXXDXX
GLLLLLLLXXXXDEX
XEEEEEEUEEDLLEX
XERRRDEUEEDEEEX
XEUEEDEUEERRRDX
XEUEEDEUEEEEEDX
XEUEERRULLEEEDX
RRUEEEEEEUEEEDX
XXXXXXXXXULLLLX
XXXXXXXXXXXXXXX