2, 0
XXDXXXXXXXXXXXX
XEDEEEEXXXXXXXX
XEDEEEEEEXXXXXX
XERRRRDEEEEEEEE
XEEEEEDEEEEEEEE
XXEEEEDEERRRRRG
XXEEDLLEEUEEEEE
XXEEDEEEEUEEEEE
XXEERRRRRUEEXXX
XXXXXXXXXXXXXXX