2, 0
XXDXXXXXXXXXXXX
EEDEEEEEEEEEEEE
EEDEEEEEEEEEEEE
EERRRRDEEEEEEEE
EEEEEEDEEEEEEEE
EEEEEEDEERRRRRG
EEEEDLLEEUEEEEE
EEEEDEEEEUEEEEE
EEEERRRRRUEEEEE
EEEEEEEEEEEEEEE