2, 0
XXDXXXXXXXXXXXX
XEDEEEEEEEEEEEX
XEDEEEEEEEEEEEX
XERRRRDEEEEEEEX
XEEEEEDEEEEEEEX
XEEEEEDEERRRRRG
XEEEDLLEEUEEEEX
XEEEDEEEEUEEEEX
XEEERRRRRUEEEEX
XXXXXXXXXXXXXXX